2 templates
E0
WWWWWWWWWWWWWWWW
W.....HIIH.....W
W....HHIIHH....W
WHHHHHIIIIHHHHHW
WIIIIIIWWIIIIIIW
WIIIIIIWWIIIIIIW
WHHHHHIIIIHHHHHW
W....HHIIHH....W
W.....HIIH.....W
WWWWWWWWWWWWWWWW
E1
WWWWWWWWWWWWWWWW
W....HH..HH....W
W..............W
W..HH..HH..HH..W
W..............W
W....HH..HH....W
W..............W
W..HH..HH..HH..W
W..............W
WWWWWWWWWWWWWWWW